urlHelp=help/index.html
lastSaved=Last Saved
currentFile=Current File
toolbar=Herramientas
save=Guardar
print=Imprimir
cut=Cortar
copy=Copiar
paste=Pegar
delete=Borrar
undo=Deshacer
redo=Rehacer
select=Seleccionar
connect=Conectar
pan=Pan
zoomIn=Acercarse
zoomOut=Alejarse
zoom=Zoom
fit=Fit
actualSize=ActualS
selectAll=Seleccionar Todo
clearSelection=Borrar Selección
shape=Forma
format=Formato
font=Fuente
group=Agrupar
ungroup=Desagrupar
removeFromParent=Orphan
align=Alineación
left=Izquierda
right=Derecha
center=Centro
top=Arriba
middle=Middle
bottom=Bottom
collapse=Collapse
expand=Expandir
toBack=Enviar al fondo
toFront=Traer al frente
enterGroup=Enter group
exitGroup=Exit group
layout=Layout
horizontalTree=Horizontal Tree
verticalTree=Vertical Tree
fillColor=Color de relleno
strokeColor=Color de línea
gradientColor=Gradiente de color
bold=Negrita
italic=Cursiva
fontColor=Color de fuente
fontSize=Tamaño de fuente
fontFamily=Fuente
examples=Ejemplos
newDiagram=Nuevo Diagrama
image=Imagen
opacity=Opacidad
selection=Selección
editStyle=Editar estilo
enterStyle=Añadir estilo
enterColorname=Enter Colorname
enterImageUrl=Enter Image URL
enterOpacity=Enter Opacity (%)
enterFontsize=Enter Fontsize (pt)
enterFontfamily=Añadir fuente
toggleRounded=Redondeado
toggleShadow=Sombra
toggleOrientation=Orientación
openHref=Abrir URL
show=Mostrar
exportImage=Exportar imagen
exportSvg=Export SVG
changesLost=All changes will be lost!
swimlanes=Swimlanes
travelBooking=Travel Booking
notAvailable=Not available
